^^┌────────────────────────────┐^^
^^│┌────────────┐┌────────────┐│^^
^^││^^^^^^^^^^^^││^^^^^^^^^^^^││^^
^^││^┌──┐^┌───┐^││^┌───┐^┌──┐^││^^
^^││^│^^│^│^^^│^││^│^^^│^│^^│^││^^
^^││^└──┘^└───┘^└┘^└───┘^└──┘^││^^
^^││^^^^^^^^^^^^^^^^^^^^^^^^^^││^^
^^││^┌──┐^┌┐^┌──────┐^┌┐^┌──┐^││^^
^^││^└──┘^││^└──┐┌──┘^││^└──┘^││^^
^^││^^^^^^││^^^^││^^^^││^^^^^^││^^
^^│└────┐^│└──┐^││^┌──┘│^┌────┘│^^
^^└────┐│^│┌──┘^└┘^└──┐│^│┌────┘^^
^^^^^^^││^││^^^^^^^^^^││^││^^^^^^^
^^─────┘│^││^┌─~~~~─┐^││^│└─────^^
^^──────┘^└┘^│^^^^^^│^└┘^└──────^^
^^*^^^^^^^^^^│^gggg^│^^^^^^^^^^*^^
^^──────┐^┌┐^│^^^^^^│^┌┐^┌──────^^
^^─────┐│^││^└──────┘^││^│┌─────^^
^^^^^^^││^││^^^^f^^^^^││^││^^^^^^^
^^┌────┘│^││^┌──────┐^││^│└────┐^^
^^│┌────┘^└┘^└──┐┌──┘^└┘^└────┐│^^
^^││^^^^^^^^^^^^││^^^^^^^^^^^^││^^
^^││.┌──┐^┌───┐.││.┌───┐^┌──┐^││^^
^^││.└─┐│^└───┘.└┘.└───┘^│┌─┘^││^^
^^││o..││^......Pp......^││^^^││^^
^^│└─┐.││^┌┐^┌──────┐^┌┐^││^┌─┘│^^
^^│┌─┘.└┘^││^└──┐┌──┘^││^└┘^└─┐│^^
^^││^....^││^^^^││^^^^││^^^^^^││^^
^^││^┌────┘└──┐^││^┌──┘└────┐^││^^
^^││^└────────┘^└┘^└────────┘^││^^
^^││^^^^^^^^^^^^^^^^^^^^^^^^^^││^^
^^│└──────────────────────────┘│^^
^^└────────────────────────────┘^^
^^^^^^^^^^^^^^^^^^^^^^^^^^^^^^^^^^